la acera === acera - marciapiede m
las afueras === aforar - (Tec) calibrare; (corriente: Tec) misurare la portata di; (fig) stimare, valutare
la alcantarilla === alcantarilla - (subterránea) fogna; (en la calle) canaletto di scolo
el almacén === almacén - magazzino; (al por mayor) negozio all'ingrosso; (CSur: de comestibles) negozio di alimentari
el arco === arco - (tb Mús) arco; (Am Deporte) porta
el auditorio === auditorio - uditorio; (sala) auditorium m inv
el autobs
la avenida === avenida - viale m, corso; (de río) piena avenido - bien/mal avenido in accordo/disaccordo avenir - mettere d'accordo; (personas: entenderse) andare d'accordo; (ponerse de acuerdo) mettersi d'accordo; (conformarse) adattarsi</p> <p class="tip">avenir no se traduce nunca por la palabra italiana avvenire.
el ayuntamiento === ayuntamiento - (concejo) giunta comunale; (edificio) municipio
el banco === banco - panchina; (en un juego de azar, de iglesia) banco; (Com) banca
el bar === bar - bar m inv</p> <p class="tip">In tutti i bares spagnoli è possibile consumare bevande calde e fredde di tutti i tipi e mangiare qualcosa. Vengono serviti i "pinchos" e "tapas" (stuzzichini), "raciones" (porzioni) e "bocadillos" (panini), e a mezzogiorno talvolta c'è anche un menù del giorno. I bares aprono al mattino presto, per colazione, e chiudono a tarda notte.
el barrio === barrio - quartiere m; (en las afueras) periferia barrer - spazzare, scopare
la biblioteca === biblioteca - biblioteca
el bloque === bloque - blocco; (de noticias) rubrica
la bolsa === bolsa - borsa; (de la basura) sacchetto; (CAm, Méx) : (bolsillo) tasca
el buzón === buzón - cassetta della posta
la cafeteria === cafetería - bar m inv, buffet m inv</p> <p class="tip">Le cafeterías sono locali pubblici dove ci si può sedere e prendere un caffè o un'altra bevanda calda mangiando una pasta o uno stuzzichino. Normalmente si paga un supplemento per sedersi al tavolo. Rispetto ai bares sono più eleganti ed offrono una scelta maggiore.
la calle === calle - via, strada; (Deporte) corsia callar - tacere; (persona, oposición) mettere a tacere; tacere; restare zitto(-a)
el callejón === callejón - vicolo
la calzada === calzada - carreggiata calzado - calzato(-a); calzatura calzar - calzare; (Tec) rincalzare; calzarse los zapatos mettersi le scarpe¿qué (número) calza? che numero porta?
la capital === capital - fondamentale; (sentencia) capitale; capitale m; capitale f
la carnicería === carnicería - macelleria
el casco antiguo === casco - (de soldado, minero, obrero) elmetto; (de motorista) casco; (Náut) scafo; (Zool) zoccolo; (pedazo roto) coccio; (auriculares) cuffia cascar - rompere; (fam: golpear) riempire di botte; (fam) ciarlare; rompersi
el castillo === castillo - castello
la catedral === catedral - cattedrale f
el centro === centro - centro centrar - centrare; (interés, atención) attirare; (Fútbol) crossare; ambientarsi; (estudio) incentrarsi
el centro comercial === centro - centro centrar - centrare; (interés, atención) attirare; (Fútbol) crossare; ambientarsi; (estudio) incentrarsi
el centro de congresos === centro - centro centrar - centrare; (interés, atención) attirare; (Fútbol) crossare; ambientarsi; (estudio) incentrarsi
el cine === cine - cinema m inv ceñir - (apretar) stringere; (rodear) cingere; (vestido) restringersi
el ciudadano === ciudadano - cittadino(-a)
la comisaría === comisaría - (tb: comisaría de Policía)commissariato di Polizia
la cotaminación
la polución === polución - (contaminación) inquinamento; (de semen) polluzione f
el contenedor === contenedor - contenitore m; (para transporte) container m inv
el cruce === cruce - ver cruzar; incrocio; (Telec) interferenza cruzar - incrociare; (calle, desierto) attraversare; (cheque) sbarrare; incrociarsi; (en calle, carretera) mettersi di traverso
el cuartel === cuartel - caserma
la cuesta === cuesta - ver costar; pendio costar - costare
la duputación
la droguería === droguería - emporio (che vende prodotti di pulizia, pittura ecc)
el edificio === edificio - edificio
el encanto === encanto - (atractivo) fascino encantar - incantare; (gustar) piacere a
el escaparate === escaparate - vetrina
la estación/parada de metro
el estadio === estadio - stadio
el estanco === estanco - tabaccheria estancar - (líquido) raccogliere; (ventas) bloccare; ristagnare; (fig) arenarsi</p> <p class="tip">estanco no se traduce nunca por la palabra italiana stanco.Le sigarette, i tabacchi, i francobolli e i moduli ufficiali sono venduti, in monopolio statale, negli estancos. Si può acquistare sigarette e tabacchi anche nei bar e nei chioschi, ma in genere a prezzi più alti.
el estanque === estanque - ver estancar; stagno estancar - (líquido) raccogliere; (ventas) bloccare; ristagnare; (fig) arenarsi</p> <p class="tip">estancar no se traduce nunca por la palabra italiana stancare.
el estilo === estilo - stile m
la exposición === exposición - esposizione f
la farmacia === farmacia - farmacia
el farol === farol - lanterna
la farola === farola - lampione m
la fuente === fuente - (tb fig) fonte f; (construcción) fontana; (bandeja) vassoio
la galería === galería - galleria
la gastronomia === gastronomía - gastronomia
la glorieta === glorieta - (de jardín) pergolato; (Auto) : (plaza) rotonda
el gobierno === gobierno - ver gobernar; (tb Náut) governo gobernar - (país) governare; (nave) pilotare; governare
la heladería === heladería - gelateria
la iglesia === iglesia - chiesa
el jardin === jardín - giardino
la joyería === joyería - gioielleria
la jugetería
la librería === librería - (tb mueble) libreria
la manzana === manzana - mela; (de edificios) isolato
el mercado === mercado - mercato
el metro === metro - metro; (tb: (tren) : metropolitano)metropolitana
la mezquita === mezquita - moschea
el ministerio === ministerio - ministero
el monumento === monumento - monumento
la muralla === muralla - muraglia
el museo === museo - museo
la oferta === oferta - offerta
la oficina de correos === oficina - ufficio</p> <p class="tip">oficina no se traduce nunca por la palabra italiana officina.
el palacio === palacio - palazzo
la panadería === panadería - panetteria
la papelera === papelera - cestino
la papelería === papelería - cartoleria
la parada de autobus === parada - fermata; (de actividad, proceso) interruzione f; (militar, de balón) parata parado - fermo(-a); (Esp: sin empleo) disoccupato(-a); (Am: de pie) in piedi; (Esp) disoccupato(-a) parar - fermare; (balón) parare; smettere; (tren, autobús) fermare; fermarsi; (Am: ponerse de pie) alzarsi
la parada de metro === parada - fermata; (de actividad, proceso) interruzione f; (militar, de balón) parata parado - fermo(-a); (Esp: sin empleo) disoccupato(-a); (Am: de pie) in piedi; (Esp) disoccupato(-a) parar - fermare; (balón) parare; smettere; (tren, autobús) fermare; fermarsi; (Am: ponerse de pie) alzarsi
el parlamento === parlamento - parlamento parlamentar - negoziare
el parque === parque - parco parqué - parquet m inv
el paseo === paseo - passeggiata; (distancia corta) breve tratto pasear - portare a spasso; passeggiare; fare una passeggiata
el paso de cebra === paso - passo; (tránsito) passaggio; (Telec) scatto pasar - passare; (de un lugar a otro) spostare; (barrera, meta) oltrepassare; (atravesar) attraversare; (coche) sorpassare; (frío, calor, hambre) avere; passare; (ocurrir) succedere; (entrar) entrare; passare; (excederse) esagerare; (alimento) andare a male
la pastelería === pastelería - pasticceria
la confitería === confitería - (tienda) pasticceria; (Río de la Plata: café) caffè m inv
el pavimento === pavimento - pavimento; (de carretera) manto (stradale)
el peatón === peatón - pedone m
la peluqueria === peluquería - parrucchiere m
la pescaderia === pescadería - pescheria
la plaza === plaza - piazza; (mercado) mercato; (empleo) posto
la población === población - popolazione f; (pueblo, ciudad) centro (abitato)
la polución === polución - (contaminación) inquinamento; (de semen) polluzione f
el pueblo === pueblo - ver poblar; popolo; (población pequeña) paese m poblar - popolare
el ppuente
el quiosco === quiosco - chiosco
el rascacielos === rascacielos - grattacielo
el restaurante === restaurante - ristorante m
la rotonda === rotonda - rotonda
el semaforo === semáforo - (Auto) semaforo
la sinagoga === sinagoga - sinagoga
el supermecado
el teatro === teatro - teatro
la tienda de ropa === tienda - ver tender; negozio tender - tendere; (ropa) stendere; (tumbar) sdraiare; tender a tendere a; stendersi, sdraiarsi
la tienda de ultramarinos === tienda - ver tender; negozio tender - tendere; (ropa) stendere; (tumbar) sdraiare; tender a tendere a; stendersi, sdraiarsi
la torre === torre - torre f; (Elec) traliccio
el trafico === tráfico - traffico traficar - traficar con smerciare
el turista === turista - turista mf
el vecino === vecino - vicino(-a); vicino(-a) (di casa); (residente en la zona) residente mf
la zapateria === zapatería - (tienda) negozio di scarpe; (fábrica) calzaturificio
amurallado === amurallar - cintare
antiguo === antiguo - antico(-a); (pey) antiquato(-a); (cliente etc) vecchio(-a); los antiguos gli antichi mplsu antiguo novio il suo ex fidanzatoa la antigua all'antica
autonomico === autonómico - (elecciones) regionale; (política) autonomistico(-a)
arquitectonico === arquitectónico - architettonico(-a)
artistico === artístico - artistico(-a)
celebre === célebre - celebre celebrar - celebrare; (Rel) servire messa; tenersi
civil === civil - civile; ≈ carabiniere m
comercial === comercial - commerciale
concurrido === concurrido - frequentato(-a) concurrir - (factores, sucesos) contribuire; (ríos, avenidas) unirsi; (público) partecipare
cosmopolita === cosmopolita - cosmopolita mf
cultural === cultural - culturale
espectacular === espectacular - spettacolare; (impresionante) impressionante
funcional === funcional - funzionale
gastronomico
gratuito === gratuito - gratuito(-a)
historico === histórico - storico(-a)
impresionante === impresionante - impressionante
industrial === industrial - industriale
moderno === moderno - moderno(-a)
monumental === monumental - monumentale
municipal === municipal - municipale; (tb: policía municipal)polizia municipale, vigili mpl urbani
nacional === nacional - nazionale
oficial === oficial - ufficiale; (Mil) ufficiale m; (en un trabajo manual) operaio(-a) qualificato, -a; (en una oficina) funzionario(-a)
pintoresco === pintoresco - pittoresco(-a)
popular === popular - popolare
privado === privado - privato(-a) privar - (despojar) privare; privarse de (abstenerse) rinunciare aprivar a algn de hacer impedire a qn di fareme privan las motos vado pazzo per le moto
provincial
publico === público - pubblico(-a); pubblico publicar - pubblicare; (secreto) rivelare, rendere pubblico(-a)
tipico === típico - tipico(-a); (traje) tradizionale
turistico === turístico - turistico(-a)
sugerente
urbano === urbano - urbano(-a)
admirar === admirar - (estimar) ammirare; (asombrar) stupire; admirarse de stupirsi dino es de admirar que... non c'è da stupirsi che...
ajardinar
apreciar === apreciar - (reconocer el mérito) apprezzare; (sentir estima) stimare
callejear === callejear - andare in giro
caminar === caminar - camminare; percorrere
conocer === conocer - conoscere; (reconocer) riconoscere, distinguere; conoscersi
construir === construir - costruire; (teoría) elaborare
contaminar === contaminar - (aire, agua) inquinare
cruzar === cruzar - incrociare; (calle, desierto) attraversare; (cheque) sbarrare; incrociarsi; (en calle, carretera) mettersi di traverso
indicar === indicar - indicare
informarse === informar - informare; (dar cuenta de) informar de/sobre dare notizie su; informarse (de) informarsi (su)(les) informó de que... (li) informò che...
orientarse === orientar - orientare; (esfuerzos) dirigere; orientarse orientarsiorientarse hacia/en/su orientarsi verso/in/su
pasear === pasear - portare a spasso; passeggiare; fare una passeggiata
pavimentar === pavimentare - (stanza, strada) pavimentar, revestir
recorrer === recorrer - percorrere
rodear === rodear - circondare; rodearse de amigos circondarsi di amicirodeado de misterio avvolto nel mistero
visitar === visitar - (familia etc) fare visita a; (ciudad, museo) visitare
vivir === vivir - vivere
